11111111111
1E000000CP1
11111111111
